9.\nx
o........
..o..o...
......o.o
.........
..oo...oo
......oo.
.o.o....o
..o...o..
.o....o.o
